111111111
1C001C0E1
10C010001
1P00000C1
111111111