11111111111111111111
1P100000001010000011
10101111101010111011
100010C0101000100011
11111010101011101011
10000010101000101011
11111110101110101111
1C000000100010100011
1011111111101C111011
10000000000010001011
10111111111111101011
10000000001000001011
11111111101011111011
101C0000101010001011
10101110101110101011
10101010100000100011
10101010111111111011
1000001000C000000001
111111111111111110E1
11111111111111111111