11111111
1G00P0E1
100011C1
11111111