111111111
1G00000E1
1000000G1
1P0CCCC01
111111111