111111111111111111111
1000C0000000000000001
11100000C000G00G11001
100P000G0001111000001
100111000C00000000001
100111000000C00000001
10011100000G000000001
100G000G0000E00000001
10G000C00000000000001
10000000000C000000001
111111111111111111111