1111111111111111
1000C00000000001
11100000C000G001
100P000G00011111
100111000C000001
100111000000C001
10011100000G0001
100G000G0000E001
10G000C000000001
1111111111111111