111111111111111111111111111
1000C0000000000000000000001
100G000G0000C0000000G00C001
11100000C000G00000000000001
100P000G000111110000G000001
100111000C011E1100000C00G01
100111000001C00100000010001
10011100000G010000G0001C001
100G000G0000C00000000010001
10G000C00000000000110100001
100G000G0000C0000000C01G001
10011100000G0000000G1000001
10011100000G00000000000C001
111111111111111111111111111