111111111111111111111111111111111
1000C0000000000000000000000000001
100G000G0000C0000000G00C000000001
11100000C000G00000000000001111111
100P000G000111110000G00000000G001
100111000C00000000000C00G000C0001
100111000001C00100000010000000001
10011100000G010000G0001C000011111
100G000G0000C00000000010000000001
10G000C00000000000110100000000001
100G000G0000C0000000C01G00000G001
10011100000G0000000G1000000C00001
100000000000011111110000000000001
10000000000001GGGGG10000000111111
100000C0000001G0E0G10000000000001
10000111110001G000G10000000G00001
10000C0000000CCCCCCC0000000000001
111111111111111111111111111111111