1111111111
1000000011
1111111011
100C001011
1011111011
1010C00011
1010111111
10000C0001
1111111PE1
1111111111