1111111111
1P00000011
1111111011
100C001011
1011111011
1010C00011
1010111111
10000C0001
11111110E1
1111111111