111111111111111111111111
100000000000000000000001
110111100000000000000001
10PC0010000E000000000001
101111100000000000000001
1000C0000000000000000001
100010000000000000000001
111111111111111111111111