111111111111111111111111
1P0000000000000000000001
110111100000000000000001
100C00100000000000000001
101111100000000000000001
100EC0000000000000000001
100010000000000000000001
111111111111111111111111