1111111111111111111111111
1P10001010000010000000001
1010101010101010111111101
10001010001010101000C0101
1111101111101010101111101
1010001000001010100010001
1010111011111010111010101
1010100C10100010001010101
1010101010101111101010101
10001010101C1010000010101
1011111010101010111110101
1000000010101000100000101
1111111110101011101111101
1000001000101010001000101
1010101110101110111011101
1010100000100000100010001
1110111111111111101110111
10001000C0000010000000101
1011101111101110111111101
1000000010001000100000001
11111111101010111011111C1
1000000000101000001000001
1011111111111111111011111
10000000000000000C00000E1
1111111111111111111111111