111111111111111111111111
1P0000100000010000000011
111110101011111010111001
100000101000000010001001
101111101111111111101111
100010000000000010100001
111011111111111010111011
1010000010000C1000100001
101111101011111110101011
100000101000001000101001
101110101110101011101011
101C10100010100010001001
101010111011111010111011
101010001010001C10100001
101011101010101110101111
101000100010100010101001
101110111110111010101001
100000100000101010101001
111110101111101010101001
1000100010000010101C0001
101011111011101010111001
101000000000100000100011
1C10010101001010101110E1
111111111111111111111111