11111111111111111111111111111111111111111111111111
1P100000000010000000000010000010000000100000000011
10101011101110111011111011111010111110101111101011
10101010001000101000001000100010000010100010001011
10111011111011101111101110101011101110111010111011
10001000000010000000101000001010001000001010001011
11101C11111110101111101011111110111011111011101011
10101010001000101000001000100000101000000000101011
101010101010111010111111101011111011111111111C1011
10001000101010001010100000100000000000100010001011
10111111101010111010101111111111111110111010111011
10100000101010001010001000000000000000000010001011
10111010101011101011101011111111111110111110101111
10001010000010001000101000100000100010100010100011
11101111111110111110111110101110101010101011111011
10101000100010100000100010101000101010101010000011
10101010101110101111101010101011101011101010111011
1010001010000010000000100C101010001000001010001011
10111110111111111011111111101010111111111011101011
1000001000100000101000100010100010001000001C001011
10111011101011101110101010101111111010111110111011
1000100010001010001010001000100C000010001000100011
11101110111110111010111111111011101111101011101111
1000001000000000000010000000000010C000000010000001
111111111111111111111111111111111111111111111111E1
11111111111111111111111111111111111111111111111111