111111111
1C0G100E1
1C00100C1
1P00000C1
111111111